111111111111
1P1111111111
10100C000001
1010111111E1
10100C000001
10001C111111
111111111111