11111111111111111111
1P111111111100001111
10100C00000101010101
1010111111E1011110C1
10100C0000000C000001
10001C1111100000C001
11111111111111111111