11111111111111111111
1P111111111100001111
10100C00000C00010101
1010111111E10K0110C1
10100C00000000000001
10001C1111100000C001
10000000000000000001
10000000000000000001
10000000000000000001
10000000000000000001
11111111111111111111