11111111111111111111
1P11111111110K001111
10100C00000C01010101
1010111111E1011110C1
10100C000KK00C000001
10001C1111100000C001
11111111111111111111