11111111111111111111
10111111111100001111
100P0C00000C00010101
100K111111E1000110C1
10000C00000000000001
10001C1111100000C001
10000000000000000001
10000000000000000001
10000000000000000001
10000000000000000001
11111111111111111111