111111111111111111111111
11011100K000CC0010101111
1K01100000CC0111000000C1
1C00K0000010000C0C0C0CC1
1K00000K1111100111111101
11111101111111C1C00000C1
111111011111110101111111
111111011111110101111111
11P1110K0000CC0000101111
10011000K0CC0111000000C1
1E0000000010K00C0C0C0CC1
100000011111100111111101
111111K1111111C1C00000C1
111111111111111111111111